Classic Highschool Drama But with Murder
An Interactive Fiction by a bunch of nerds
Release 1 / Serial number 180610 / Inform 7 build 6M62 (I6/v6.33 lib 6/12N) SD

Underclassmen Hallway
The normally busy hallway seems eeriely quiet after school hours.

You can see a scimitar, My Locker (closed) and Diamonds Locker (closed) here.

>leave
But you aren't in anything at the moment.

>go to Gazebo
You can't see any such thing.

>eat a parrot
I only understood you as far as wanting to eat yourself.

>no
That was a rhetorical question.

>yes
That was a rhetorical question.

* * *

Classic Highschool Drama But with Murder
An Interactive Fiction by a bunch of nerds
Release 1 / Serial number 180610 / Inform 7 build 6M62 (I6/v6.33 lib 6/12N) SD

Underclassmen Hallway
The normally busy hallway seems eeriely quiet after school hours.

You can see a scimitar, My Locker (closed) and Diamonds Locker (closed) here.

>look
Gazebo
A white canvas parasol raised up on stakes driven into the grass.

* * *

Classic Highschool Drama But with Murder
An Interactive Fiction by a bunch of nerds
Release 1 / Serial number 180610 / Inform 7 build 6M62 (I6/v6.33 lib 6/12N) SD

Underclassmen Hallway
The normally busy hallway seems eeriely quiet after school hours.

You can see a scimitar, My Locker (closed) and Diamonds Locker (closed) here.

>open sesame
Open Sesame!

* * *

Classic Highschool Drama But with Murder
An Interactive Fiction by a bunch of nerds
Release 1 / Serial number 180610 / Inform 7 build 6M62 (I6/v6.33 lib 6/12N) SD

Underclassmen Hallway
The normally busy hallway seems eeriely quiet after school hours.

You can see a scimitar, My Locker (closed) and Diamonds Locker (closed) here.

>examine key
Seems old and rusty. Doesn't look like it fits in the lock

>examine dog
Fuck cats

>examine metal rod
fuck metal rods

>go north
You can't go that way.

>escape
That's not a verb I recognise.

* * *

>examine key
Seems old and rusty. Doesn't look like it fits in the lock

>go north
You can't go that way.

* * *

>examine butt
Don't sniff it.

* * *

>examine butt
Don't sniff it.

you sniffed the butt. You win.

* * *

Classic Highschool Drama But with Murder
An Interactive Fiction by a bunch of nerds
Release 1 / Serial number 180610 / Inform 7 build 6M62 (I6/v6.33 lib 6/12N) SD

Underclassmen Hallway
The normally busy hallway seems eeriely quiet after school hours.

You can see a scimitar, My Locker (closed) and Diamonds Locker (closed) here.

>x orange
It's a small hard pinch-skinned thing from the lunch room, probably with lots of pips and no juice.

>x nap
You can't see any such thing.

>x napkin
Slightly crumpled.

* * *

Classic Highschool Drama But with Murder
An Interactive Fiction by a bunch of nerds
Release 1 / Serial number 180610 / Inform 7 build 6M62 (I6/v6.33 lib 6/12N) SD

Underclassmen Hallway
The normally busy hallway seems eeriely quiet after school hours.

You can see a scimitar, My Locker (closed) and Diamonds Locker (closed) here.

>west
Men's Restroom
Well, yes, you really shouldn't be in here. But the nearest women's room is on the other side of the building, and at this hour you have the labs mostly to yourself. All the same, you try not to read any of the things scrawled over the urinals which might have been intended in confidence.

>east
Wilkie Memorial Research Wing

>west
Men's Restroom

>east
Wilkie Memorial Research Wing

* * *

>west
Men's Restroom
Well, yes, you really shouldn't be in here. But the nearest women's room is on the other side of the building, and at this hour you have the labs mostly to yourself. All the same, you try not to read any of the things scrawled over the urinals which might have been intended in confidence.

>esat
That's not a verb I recognise.

>east
Wilkie Memorial Research Wing
The research wing was built onto the science building in 1967, when the college's finances were good but its aesthetic standards at a local minimum. A dull brown corridor recedes both north and south; drab olive doors open onto the laboratories of individual faculty members. The twitchy fluorescent lighting makes the whole thing flicker, as though it might wink out of existence at any moment.

The Men's Restroom is immediately west of this point.

>west
Men's Restroom
Well, yes, you really shouldn't be in here. But the nearest women's room is on the other side of the building, and at this hour you have the labs mostly to yourself. All the same, you try not to read any of the things scrawled over the urinals which might have been intended in confidence.

* * *

>n
You can't go that way.

>s
You can't go that way.

>w
Mr Redmans Classroom

* * *

>look
Steps
Hundreds of kids go up and down these steps everyday.

>go north
Great Outdoors
Its pleasent and breezy. Much better than that that big block of concrete they call a school

You can see rope here.

>go south
Steps
Hundreds of kids go up and down these steps everyday.

>go south
Underclassmen Hallway
The normally busy hallway seems eeriely quiet after school hours.

You can see My Locker (closed) and Diamonds Locker (closed) here.

* * *

>look
Room 212
Mrs Ford's Classroom. She's a real stickler for the rules. Everything with its purpose, everything in its place.

You can see Mrs Ford here.

>go west
Underclassmen Hallway
The normally busy hallway seems eeriely quiet after school hours.

You can see My Locker (closed) and Diamonds Locker (closed) here.

* * *

>look
Room 211
Mr Redman's Classroom. He's known for beating the living hell out of his kids. Not cool Mr Redman. Not cool.

You can see monkey wrench, baseball bat and Mr Redman here.

>take wrench
Taken.

* * *

>go north
Great Outdoors
Its pleasent and breezy. Much better than that that big block of concrete they call a school

You can see rope here.

>report rope damage
rope has 2 damage points.

* * *

Classic Highschool Drama But with Murder
An Interactive Fiction by a bunch of nerds
Release 1 / Serial number 180610 / Inform 7 build 6M62 (I6/v6.33 lib 6/12N) SD

Underclassmen Hallway
The normally busy hallway seems eeriely quiet after school hours.

You can see a scimitar, My Locker (closed) and Diamonds Locker (closed) here.

>n
Steps
Hundreds of kids go up and down these steps everyday.

>s
Underclassmen Hallway
The normally busy hallway seems eeriely quiet after school hours.

>w
Mr Redmans Classroom

>e
Underclassmen Hallway
The normally busy hallway seems eeriely quiet after school hours.

>e
Mrs Fords Classroom

>w
Underclassmen Hallway
The normally busy hallway seems eeriely quiet after school hours.

* * *

Classic Highschool Drama But with Murder
An Interactive Fiction by a bunch of nerds
Release 1 / Serial number 180610 / Inform 7 build 6M62 (I6/v6.33 lib 6/12N) SD

Underclassmen Hallway
The normally busy hallway seems eeriely quiet after school hours.

You can see a scimitar, My Locker (closed) and Diamonds Locker (closed) here.

>fuck
What do you want to fuck?

>fuck fuck fuck
That's not a verb I recognise.

* * *

>fuck
What do you want to fuck?

>fuck
That's not a verb I recognise.

>fuck
That's not a verb I recognise.

* * *

>fuck
What do you want to fuck?

>fuck the police
You can't see any such thing.

>fuck my locker
FUCK DA POLICE

* * *

>fuck
What do you want to fuck?

>fuck my  locker
You fucked it

>fuck the police
You can't see any such thing.

>fuck the hallway
You can't see any such thing.

>look
Underclassmen Hallway
The normally busy hallway seems eeriely quiet after school hours.

You can see My Locker and Diamonds Locker (in which is Diamonds Pencil) here.

>fuck the underclassmen
You can't see any such thing.

* * *

Classic Highschool Drama But with Murder
An Interactive Fiction by a bunch of nerds
Release 1 / Serial number 180610 / Inform 7 build 6M62 (I6/v6.33 lib 6/12N) SD

Underclassmen Hallway
The normally busy hallway seems eeriely quiet after school hours.

You can see a scimitar, My Locker (closed) and Diamonds Locker (closed) here.

>s
Upperclassmen Junction
Long coridors stretching left and right. An intimidating sight for underclassman.

>e
East Upperclassmen Hall
Senior side of the hallway. Close to the Gym.

>s
Mr Hartmans Classroom
I heard Mr Hartman once was caught eating out of the Cafeteria Garbage.

You can see Diamond here.

>look
Mr Hartmans Classroom
I heard Mr Hartman once was caught eating out of the Cafeteria Garbage.

You can see Diamond here.

>examine diamond
An angel that has graced this school with her presence. She's soooooo hot.

>ask diamond hello
I didn't understand that sentence.

>talk to diamond
That's not a verb I recognise.

>Tell diamond hello
I didn't understand that sentence.

* * *

Classic Highschool Drama But with Murder
An Interactive Fiction by a bunch of nerds
Release 1 / Serial number 180610 / Inform 7 build 6M62 (I6/v6.33 lib 6/12N) SD

Underclassmen Hallway
The normally busy hallway seems eeriely quiet after school hours.

You can see a scimitar, My Locker (closed) and Diamonds Locker (closed) here.

>open my locker
You need the right combination to open this locker. Spin the lock to _-_-_ to open

>spin my locker to 1999
My Locker opens, revealing nothing.

* * *

>open my locker
You need the right combination to open this locker. Spin the lock to _-_-_ to open

>look at my locker
Ah, my sweet old locker. Smells like teen spirit.

>look in my locker
You can't see inside, since My Locker is closed.

>spin my locker to 1999
My Locker opens, revealing nothing.

* * *

Classic Highschool Drama But with Murder
An Interactive Fiction by a bunch of nerds
Release 1 / Serial number 180610 / Inform 7 build 6M62 (I6/v6.33 lib 6/12N) SD

Underclassmen Hallway
The normally busy hallway seems eeriely quiet after school hours.

You can see a scimitar, My Locker (closed) and Diamonds Locker (closed) here.

>spin my locker to 1999
My Locker opens, revealing nothing.

>look
Underclassmen Hallway
The normally busy hallway seems eeriely quiet after school hours.

You can see My Locker (empty) and Diamonds Locker (closed) here.

>close my locker
It isn't something you can close.

>go north
Steps
Hundreds of kids go up and down these steps everyday.

>go south
Underclassmen Hallway
The normally busy hallway seems eeriely quiet after school hours.

You can see My Locker (empty) and Diamonds Locker (closed) here.

* * *

>look
Steps
Hundreds of kids go up and down these steps everyday.

>go south
Underclassmen Hallway
The normally busy hallway seems eeriely quiet after school hours.

You can see My Locker (closed) and Diamonds Locker (closed) here.

* * *

>spin my locker to 1999
My Locker opens, revealing nothing.

>close my locker
It isn't something you can close.

>scene
That's not a verb I recognise.

* * *

>look
Upperclassmen Junction
Long coridors stretching left and right. An intimidating sight for underclassman.

You can see a scimitar here.

>go east
East Upperclassmen Hall
Senior side of the hallway. Close to the Gym.

>go west
Upperclassmen Junction
Long coridors stretching left and right. An intimidating sight for underclassman.

>go west
West Upperclassmen Hall
Junior side of the hallway. Close to the Cafeteria.

>go west
Cafeteria
Serving barely-edible food substance since 1989.

You can see a hankerchief here.

* * *

>look
Upperclassmen Junction
Long coridors stretching left and right. An intimidating sight for underclassman.

You can see a scimitar here.

>go south
You can't go that way.

>go east
East Upperclassmen Hall
Senior side of the hallway. Close to the Gym.

* * *

>look
East Upperclassmen Hall
Senior side of the hallway. Close to the Gym.

>go east
Gym
A smelly old gymnasium. Full of sweat and humilation.

>go east
You can't go that way.

I beg your pardon?

>go south
You can't go that way.

>go north
You can't go that way.

>go west
East Upperclassmen Hall
Senior side of the hallway. Close to the Gym.

>go west
Upperclassmen Junction
Long coridors stretching left and right. An intimidating sight for underclassman.

* * *

>go west
West Upperclassmen Hall
Junior side of the hallway. Close to the Cafeteria.

>go west
Cafeteria
Serving barely-edible food substance since 1989.

>go west
You can't go that way.

>look
Cafeteria
Serving barely-edible food substance since 1989.

* * *

>look
Upperclassmen Junction
Long coridors stretching left and right. An intimidating sight for underclassman.

You can see a scimitar here.

>go north
Underclassmen Hallway
The normally busy hallway seems eeriely quiet after school hours.

You can see My Locker (closed) and Diamonds Locker (closed) here.

* * *

>look
Room 212
Mrs Ford's Classroom. She's a real stickler for the rules. Everything with its purpose, everything in its place.

You can see candlestick and Mrs Ford here.

>go west
Underclassmen Hallway
The normally busy hallway seems eeriely quiet after school hours.

You can see My Locker (closed) and Diamonds Locker (closed) here.

* * *

>look
Room 211
Mr Redman's Classroom. He's known for beating the living hell out of his kids. Not cool Mr Redman. Not cool.

You can see Mr Redman here.

>go east
Underclassmen Hallway
The normally busy hallway seems eeriely quiet after school hours.

You can see My Locker (closed) and Diamonds Locker (closed) here.

* * *

>look
Steps
Hundreds of kids go up and down these steps everyday.

>go north
Great Outdoors
Its pleasent and breezy. Much better than that that big block of concrete they call a school

You can see baseball bat here.

* * *

>look
Upperclassmen Junction
Long coridors stretching left and right. An intimidating sight for underclassman.

You can see a scimitar here.

>report scimitar damage
scimitar has random number from 1 to 5 damage points.

* * *

Classic Highschool Drama But with Murder
An Interactive Fiction by a bunch of nerds
Release 1 / Serial number 180610 / Inform 7 build 6M62 (I6/v6.33 lib 6/12N) SD

Underclassmen Hallway
The normally busy hallway seems eeriely quiet after school hours.

You can see a scimitar, My Locker (closed) and Diamonds Locker (closed) here.

>spin diamonds locker to 0112
Diamonds Locker opens, revealing Diamonds Pencil.

Score! Her pencil is right where she said it would be
You hear knuckles scraping the floor. A lightning rod shoots down your spine. Brad approaches.

>take diamonds pencil
Taken.

>inventory
You are carrying:
  Diamonds Pencil

* * *

>spin diamonds locker to 0112
Diamonds Locker opens, revealing Diamonds Pencil.

Score! Her pencil is right where she said it would be
You hear knuckles scraping the floor. A lightning rod shoots down your spine. Brad approaches.

>look
Underclassmen Hallway
The normally busy hallway seems eeriely quiet after school hours.

You can see a man named Brad, My Locker (closed) and Diamonds Locker (in which is Diamonds Pencil) here.

* * *

>look
Room 212
Mrs Ford's Classroom. She's a real stickler for the rules. Everything with its purpose, everything in its place.

You can see Mrs Ford here.

>spin mrs ford to 3341
Mrs Ford does not spin.

* * *

>look
Room 212
Mrs Ford's Classroom. She's a real stickler for the rules. Everything with its purpose, everything in its place.

You can see Mrs Ford here.

>take canflestick
You can't see any such thing.

>take candlestick
Taken.

>attack mrs ford with candlestick
You attack Mrs Ford with candlestick, causing 4 points of damage!

>check mrs f health
Mrs Ford has 16 health

>report candlestick damage
candlestick has 3 damage points.

>attack mrs ford with candlestick
You attack Mrs Ford with candlestick, causing 3 points of damage!

>check mrs f health
Mrs Ford has 13 health

>report candlestick damage
candlestick has 2 damage points.

* * *

>look
Room 211
Mr Redman's Classroom. He's known for beating the living hell out of his kids. Not cool Mr Redman. Not cool.

You can see Mr Redman here.

>katana damage
That's not a verb I recognise.

* * *

>look
Steps
Hundreds of kids go up and down these steps everyday.

>go north
Great Outdoors
Its pleasent and breezy. Much better than that that big block of concrete they call a school

You can see a scimitar here.

* * *

>go south
Steps
Hundreds of kids go up and down these steps everyday.

* * *

>look
Room 212
Mrs Ford's Classroom. She's a real stickler for the rules. Everything with its purpose, everything in its place.

You can see Mrs Ford here.

>report mrs ford damage
no damage points

* * *

>look
Room 211
Mr Redman's Classroom. He's known for beating the living hell out of his kids. Not cool Mr Redman. Not cool.

You can see Mr Redman here.

>go east
Underclassmen Hallway
The normally busy hallway seems eeriely quiet after school hours.

You can see rope, My Locker (closed) and Diamonds Locker (closed) here.

>report rope damage
rope has 4 points

* * *

>look
Room 211
Mr Redman's Classroom. He's known for beating the living hell out of his kids. Not cool Mr Redman. Not cool.

You can see Mr Redman here.

>check mr r health
Mr Redman has health 20

>check bat health
the baseball bat isn't alive... yet.

* * *

>look
Room 211
Mr Redman's Classroom. He's known for beating the living hell out of his kids. Not cool Mr Redman. Not cool.

You can see Mr Redman here.

>take axe
Taken.

>attack mr r with axw
You can't see any such thing.

>attack mr r with axe
You attack Mr Redman with axe, causing 2 points of damage!

>check health mr r
You can't see any such thing.

>check mr r health
Mr Redman has 17 health

>report axe damage
axe has 2 damage points.

* * *

>take axe
Taken.

>attack mr r with axe
You attack Mr Redman with axe, causing 3 points of damage!

>go east
Underclassmen Hallway
The normally busy hallway seems eeriely quiet after school hours.

You can see monkey wrench, rope, baseball bat, My Locker (closed) and Diamonds Locker (closed) here.

* * *

>look
Room 212
Mrs Ford's Classroom. She's a real stickler for the rules. Everything with its purpose, everything in its place.

You can see Mrs Ford here.

>mrs f relationship
Mrs Ford thinks you're alright.

>attack mrs f with axe
You attack Mrs Ford with axe, causing 2 points of damage!
Mrs Ford is now your enemy.

>attack mrs f with axe
You attack Mrs Ford with axe, causing 1 point of damage!

* * *

>look
Room 211
Mr Redman's Classroom. He's known for beating the living hell out of his kids. Not cool Mr Redman. Not cool.

You can see Mr Redman here.

>take wrench
Taken.

>report wrench damage
monkey wrench has 3 damage points.

>attack mr r with wrench
You attack Mr Redman with monkey wrench, causing 3 points of damage!

>report wrench damage
monkey wrench has 3 damage points.

* * *

>look
Room 211
Mr Redman's Classroom. He's known for beating the living hell out of his kids. Not cool Mr Redman. Not cool.

You can see Mr Redman here.

>attack mr redman with fist
You attack Mr Redman with the fist which has damage 1, causing 5 points of damage!
Mr Redman is now your enemy.

* * *

>look
Room 211
Mr Redman's Classroom. He's known for beating the living hell out of his kids. Not cool Mr Redman. Not cool.

You can see Mr Redman here.

>attack mr r with fist
You attack Mr Redman with the fist, causing 1 point of damage!
Mr Redman is now your enemy.

>fist damage
fist has 1 damage points.

>mr r health
Mr Redman has 19 health

>take wrench
Taken.

>attack mr r with wrench
You attack Mr Redman with monkey wrench, causing 3 points of damage!
Mr Redman is now your enemy.

* * *

>look
Room 211
Mr Redman's Classroom. He's known for beating the living hell out of his kids. Not cool Mr Redman. Not cool.

You can see Mr Redman here.

>attack mr redman with fish
You can't see any such thing.

* * *

>look\
That's not a verb I recognise.

>look
Room 211
Mr Redman's Classroom. He's known for beating the living hell out of his kids. Not cool Mr Redman. Not cool.

You can see Mr Redman here.

* * *

>look
Room 212
Mrs Ford's Classroom. She's a real stickler for the rules. Everything with its purpose, everything in its place.

You can see candlestick and Mrs Ford here.

>report damage candlestick
That's not a verb I recognise.

* * *

>check redman rapport
I only understood you as far as wanting to check Mr Redman.

* * *

>check mr r rapport
I only understood you as far as wanting to check Mr Redman.

>check mr r relationship
I only understood you as far as wanting to check Mr Redman.

* * *

Classic Highschool Drama But with Murder
An Interactive Fiction by a bunch of nerds
Release 1 / Serial number 180610 / Inform 7 build 6M62 (I6/v6.33 lib 6/12N) SD

Underclassmen Hallway
The normally busy hallway seems eeriely quiet after school hours.

You can see a scimitar, My Locker (closed) and Diamonds Locker (closed) here.

>invintory
That's not a verb I recognise.

>check inventory
You can't see any such thing.

>inventory
You are carrying:
  a fist which has damage 1

>hold fist
You already have that.

>carry fist
You already have that.

>punch
(yourself with the fist which has damage 1)

* * *

Classic Highschool Drama But with Murder
An Interactive Fiction by a bunch of nerds
Release 1 / Serial number 180610 / Inform 7 build 6M62 (I6/v6.33 lib 6/12N) SD

Underclassmen Hallway
The normally busy hallway seems eeriely quiet after school hours.

You can see a scimitar, My Locker (closed) and Diamonds Locker (closed) here.

>report rope damage
rope has 2 damage points.

>report my locker damage
no damage points

* * *

Classic Highschool Drama But with Murder
An Interactive Fiction by a bunch of nerds
Release 1 / Serial number 180610 / Inform 7 build 6M62 (I6/v6.33 lib 6/12N) SD

Underclassmen Hallway
The normally busy hallway seems eeriely quiet after school hours.

You can see a scimitar, My Locker (closed) and Diamonds Locker (closed) here.

>inventory
You are carrying:
  a fish
  a fist

* * *

>look
Room 211
Mr Redman's Classroom. He's known for beating the living hell out of his kids. Not cool Mr Redman. Not cool.

You can see katana and Mr Redman here.

>attack mr r with fish
The fish does not qualify as a weapon.

* * *

Classic Highschool Drama But with Murder
An Interactive Fiction by a bunch of nerds
Release 1 / Serial number 180610 / Inform 7 build 6M62 (I6/v6.33 lib 6/12N) SD

Underclassmen Hallway
The normally busy hallway seems eeriely quiet after school hours.

You can see a scimitar, My Locker (closed) and Diamonds Locker (closed) here.

>attack my locker
You can only do that to something animate.

* * *

Classic Highschool Drama But with Murder
An Interactive Fiction by a bunch of nerds
Release 1 / Serial number 180610 / Inform 7 build 6M62 (I6/v6.33 lib 6/12N) SD

Underclassmen Hallway
The normally busy hallway seems eeriely quiet after school hours.

You can see a scimitar, My Locker (closed) and Diamonds Locker (closed) here.

>report player health
You can't see any such thing.

>report axe damage
axe has 3 damage points.

>report axe health
You can only do that to something animate.

* * *

Classic Highschool Drama But with Murder
An Interactive Fiction by a bunch of nerds
Release 1 / Serial number 180610 / Inform 7 build 6M62 (I6/v6.33 lib 6/12N) SD

Underclassmen Hallway
The normally busy hallway seems eeriely quiet after school hours.

You can see a scimitar, My Locker (closed) and Diamonds Locker (closed) here.

>check wrench health
You can only do that to something animate.

* * *

Classic Highschool Drama But with Murder
An Interactive Fiction by a bunch of nerds
Release 1 / Serial number 180610 / Inform 7 build 6M62 (I6/v6.33 lib 6/12N) SD

Underclassmen Hallway
The normally busy hallway seems eeriely quiet after school hours.

You can see a scimitar, My Locker (closed) and Diamonds Locker (closed) here.

>take katana
Taken.

* * *

>look
Room 211
Mr Redman's Classroom. He's known for beating the living hell out of his kids. Not cool Mr Redman. Not cool.

You can see Mr Redman here.

>check mr r relationship
I only understood you as far as wanting to check Mr Redman.

>check mr r health
Mr Redman has 20 health

* * *

Classic Highschool Drama But with Murder
An Interactive Fiction by a bunch of nerds
Release 1 / Serial number 180610 / Inform 7 build 6M62 (I6/v6.33 lib 6/12N) SD

Underclassmen Hallway
The normally busy hallway seems eeriely quiet after school hours.

You can see a scimitar, My Locker (closed) and Diamonds Locker (closed) here.

>gow est
That's not a verb I recognise.

* * *

>look
Room 211
Mr Redman's Classroom. He's known for beating the living hell out of his kids. Not cool Mr Redman. Not cool.

You can see Mr Redman here.

>check mr r rapport
I only understood you as far as wanting to check Mr Redman.

>check redman rapport
I only understood you as far as wanting to check Mr Redman.

* * *

Classic Highschool Drama But with Murder
An Interactive Fiction by a bunch of nerds
Release 1 / Serial number 180610 / Inform 7 build 6M62 (I6/v6.33 lib 6/12N) SD

Underclassmen Hallway
The normally busy hallway seems eeriely quiet after school hours.

You can see a scimitar, My Locker (closed) and Diamonds Locker (closed) here.

>know ford relationship
You can't see any such thing.

* * *

>know ford relationship
Mrs Ford thinks you're alright.
Mrs Ford has rapport value: 3

>go west
Underclassmen Hallway
The normally busy hallway seems eeriely quiet after school hours.

You can see monkey wrench, katana, My Locker (closed) and Diamonds Locker (closed) here.

>go est
You can't see any such thing.

* * *

>know mr r relationship
Mr Redman doesn't really ever think of you.
Mr Redman has rapport value: 2

* * *

Classic Highschool Drama But with Murder
An Interactive Fiction by a bunch of nerds
Release 1 / Serial number 180610 / Inform 7 build 6M62 (I6/v6.33 lib 6/12N) SD

Underclassmen Hallway
The normally busy hallway seems eeriely quiet after school hours.

You can see a scimitar, My Locker (closed) and Diamonds Locker (closed) here.

>report katana damage
katana has 5 damage points.

* * *

Classic Highschool Drama But with Murder
An Interactive Fiction by a bunch of nerds
Release 1 / Serial number 180610 / Inform 7 build 6M62 (I6/v6.33 lib 6/12N) SD

Underclassmen Hallway
The normally busy hallway seems eeriely quiet after school hours.

You can see a scimitar, My Locker (closed) and Diamonds Locker (closed) here.

>bat damage
baseball bat has 4 damage points.

* * *

Classic Highschool Drama But with Murder
An Interactive Fiction by a bunch of nerds
Release 1 / Serial number 180610 / Inform 7 build 6M62 (I6/v6.33 lib 6/12N) SD

Underclassmen Hallway
The normally busy hallway seems eeriely quiet after school hours.

You can see a scimitar, My Locker (closed) and Diamonds Locker (closed) here.

>katana health
That's not a verb I recognise.

* * *

>look
Room 211
Mr Redman's Classroom. He's known for beating the living hell out of his kids. Not cool Mr Redman. Not cool.

You can see katana and Mr Redman here.

>katana health
the katana isn't alive... yet.

* * *

Classic Highschool Drama But with Murder
An Interactive Fiction by a bunch of nerds
Release 1 / Serial number 180610 / Inform 7 build 6M62 (I6/v6.33 lib 6/12N) SD

Underclassmen Hallway
The normally busy hallway seems eeriely quiet after school hours.

You can see a scimitar, My Locker (closed) and Diamonds Locker (closed) here.

>take wrench
Taken.

* * *

>look
Room 211
Mr Redman's Classroom. He's known for beating the living hell out of his kids. Not cool Mr Redman. Not cool.

You can see axe and Mr Redman here.

>take axe
Taken.

>attack mr r with axe
You attack Mr Redman with axe, causing 3 points of damage!
Mr Redman is now your enemy.

>attack mr r with axe
You attack Mr Redman with axe, causing 2 points of damage!

>attack mr r with axe
You attack Mr Redman with axe, causing 1 point of damage!

>attack mr r with wrench
You attack Mr Redman with monkey wrench, causing 3 points of damage!

>attack mr r with wrench
You attack Mr Redman with monkey wrench, causing 2 points of damage!

>mr r health
Mr Redman has 9 health

>mr r health
Mr Redman has 9 health

>attack mr r with wrench
You attack Mr Redman with monkey wrench, causing 1 point of damage!

>attack mr r with wrench
You attack Mr Redman with monkey wrench, causing 1 point of damage!

>mr r health
Mr Redman has -5 health

>look
Room 211
Mr Redman's Classroom. He's known for beating the living hell out of his kids. Not cool Mr Redman. Not cool.

You can see Mr Redman here.

* * *

Classic Highschool Drama But with Murder
An Interactive Fiction by a bunch of nerds
Release 1 / Serial number 180610 / Inform 7 build 6M62 (I6/v6.33 lib 6/12N) SD

Underclassmen Hallway
The normally busy hallway seems eeriely quiet after school hours.

You can see a scimitar, My Locker (closed) and Diamonds Locker (closed) here.

>take scimitar
Taken.

* * *

>look
Room 212
Mrs Ford's Classroom. She's a real stickler for the rules. Everything with its purpose, everything in its place.

You can see baseball bat and Mrs Ford here.

>take bat
Taken.

>attack mrs f with bat
You attack Mrs Ford with baseball bat, causing 4 points of damage!
Mrs Ford is now your enemy.

>attack mrs f with bat
You attack Mrs Ford with baseball bat, causing 3 points of damage!

>attack mrs f with bat
You attack Mrs Ford with baseball bat, causing 2 points of damage!

>attack mrs f with bat
You attack Mrs Ford with baseball bat, causing 1 point of damage!

>attack mrs f with scimitar
You attack Mrs Ford with the scimitar, causing 5 points of damage!

>attack mrs f with scimitar
You attack Mrs Ford with the scimitar, causing 4 points of damage!

>attack mrs f with scimitar
You attack Mrs Ford with the scimitar, causing 3 points of damage!

>attack mrs f with scimitar
You attack Mrs Ford with the scimitar, causing 2 points of damage!

>attack mrs f with scimitar
You attack Mrs Ford with the scimitar, causing 1 point of damage!

>attack mrs f with scimitar
You attack Mrs Ford with the scimitar, causing 1 point of damage!

>mrs f health
Mrs Ford has -6 health