Classic Highschool Drama But with Murder
An Interactive Fiction by a bunch of nerds
Release 1 / Serial number 180615 / Inform 7 build 6M62 (I6/v6.33 lib 6/12N) SD

 
 Hey, Diamond, its ya boi..... no that's wrong.... What's hangin girl you lookin... nah she knows she looks amazing...
 
 Damn, this is way too hard. 

 Today is the day! I'm finally going to confess my love to Diamond, the only girl that I could ever love! I think she has Mr. Hartman's Underwater Basket Weaving class first.... now where is that.....

Underclassmen Hallway
Class just started, so the normally busy hallway seems eeriely quiet.

You can see My Locker (closed) and Diamonds Locker (closed) here.

* * *

>look
Room 211
Mr Redman's Classroom. He's known for beating the living hell out of his kids. Not cool Mr Redman. Not cool.

You can see axe and Mr Redman here.

>take spear
Taken.

>help
You can GO to adjacent rooms.
 You can OPEN doors.
You can take, drop, and give items.
You can TALK to CHARACTER about TOPIC.
You can SPIN objects to NUMBER. 
Today is the day I get Diamond to date me! Now I just gotta find her...

* * *

>take wrench
Taken.

>inventory
I got myself: 
monkey wrench
a fish
a fist which has damage 1

* * *

>inventory
halberd
  a scimitar8
  a fish
  a fist

* * *

>look
Room 211
Mr Redman's Classroom. He's known for beating the living hell out of his kids. Not cool Mr Redman. Not cool.

You can see Mr Redman here.

* * *

>inventory
halberd
  a scimitar8
  a fish
  a fist

>go nowhere
You can't see any such thing.

* * *

>inventory
halberd
  a scimitar8
  a fish
  a fist

>w
BRAD: You can't run from me!

>health
That's not a verb I recognise.

>player health
That's not a verb I recognise.

* * *

>look
Upperclassmen Junction
Long coridors stretching left and right. An intimidating sight for underclassman.

You can see a scimitar here.

>take scimita
You can't see any such thing.

>take scimitar
Taken.

>go east
East Upperclassmen Hall
Senior side of the hallway. Close to the Gym.

>look
East Upperclassmen Hall
Senior side of the hallway. Close to the Gym.

>go north
You can't go that way.

>go west
Upperclassmen Junction
Long coridors stretching left and right. An intimidating sight for underclassman.

>go est
You can't see any such thing.

>e
East Upperclassmen Hall
Senior side of the hallway. Close to the Gym.

>w
Upperclassmen Junction
Long coridors stretching left and right. An intimidating sight for underclassman.

>w
West Upperclassmen Hall
Junior side of the hallway. Close to the Cafeteria.

>w
Cafeteria
Serving barely-edible food substance since 1989.

>w
You can't go that way.

>n
You can't go that way.

>e
West Upperclassmen Hall
Junior side of the hallway. Close to the Cafeteria.

>e
Upperclassmen Junction
Long coridors stretching left and right. An intimidating sight for underclassman.

>e
East Upperclassmen Hall
Senior side of the hallway. Close to the Gym.

I beg your pardon?

>e
Gym
A smelly old gymnasium. Full of sweat and humilation.

>w
East Upperclassmen Hall
Senior side of the hallway. Close to the Gym.

>n
You can't go that way.

>e
Gym
A smelly old gymnasium. Full of sweat and humilation.

* * *

>w
East Upperclassmen Hall
Senior side of the hallway. Close to the Gym.

>w
Upperclassmen Junction
Long coridors stretching left and right. An intimidating sight for underclassman.

>n
Underclassmen Hallway
Class just started, so the normally busy hallway seems eeriely quiet.

You can see My Locker (closed) and Diamonds Locker (closed) here.

* * *

>s
You can't go that way.

>e
East Upperclassmen Hall
Senior side of the hallway. Close to the Gym.

>s
Room 213
Mr. Hartman's Classroom. I heard he once was caught eating out of the Cafeteria Garbage.

You can see spear, axe, Mr Hartman and Diamond here.

>take spear
Taken.

>take axe
Taken.

>attack mr h with axe
You attack Mr Hartman with axe, causing 3 points of damage!
Mr Hartman is now your enemy.

>mr h health
Mr Hartman has 17 health

>inventory
I got myself: 
axe
spear
a scimitar
a fish
a fist

>mr h rapport
I didn't understand that sentence.

>mr h relationship
Mr Hartman doesn't much care for you

* * *

>help
You can GO to adjacent rooms. Use the commands n, s, e, w to go in each cardinal direction. 
 You can OPEN doors.
You can ATTACK someone with a WEAPON in your inventory.
You can check your inventory by simply saying INVENTORYYou can TAKE, DROP, and GIVE items. Taking an item puts it in your inventory. 
You can TALK to CHARACTER about TOPIC.
You can open a locker by saying SPIN locker to NUMBER.

>inventory
I got myself: 
a fish
a fist

* * *

>look
Room 211
Mr Redman's Classroom. He's known for beating the living hell out of his kids. Not cool Mr Redman. Not cool.

You can see spear and Mr Redman here.

>drop fist
Dropped.

>look
Room 211
Mr Redman's Classroom. He's known for beating the living hell out of his kids. Not cool Mr Redman. Not cool.

You can see a fist, spear and Mr Redman here.

>pick up mr r
I don't suppose Mr Redman would care for that.

>pick up spear
Taken.

>give spear to mr r
Mr Redman doesn't seem interested.

>attack mr r with spear
You attack Mr Redman with spear, causing 3 points of damage!
Mr Redman is now your enemy.

>mr r health
Mr Redman has 17 health

>mr r relationship
Mr Redman doesn't much care for you

* * *

>s
Upperclassmen Junction
Long coridors stretching left and right. An intimidating sight for underclassman.

1

>w
West Upperclassmen Hall
Junior side of the hallway. Close to the Cafeteria.

1

>e
Upperclassmen Junction
Long coridors stretching left and right. An intimidating sight for underclassman.

You can see spear and rope here.

>s
You can't go that way.

>take spear
Taken.

>take rope
Taken.

>e
East Upperclassmen Hall
Senior side of the hallway. Close to the Gym.

>s
Room 213
Mr. Hartman's Classroom. I heard he once was caught eating out of the Cafeteria Garbage.

You can see Mr Hartman and Diamond here.

>attack mr hartman with spear
You attack Mr Hartman with spear, causing 3 points of damage!
Mr Hartman is now your enemy.

>attack mr h with spear
You attack Mr Hartman with spear, causing 2 points of damage!

>attack mr h with spear
You attack Mr Hartman with spear, causing 1 point of damage!

>attack mr h with spear
You attack Mr Hartman with spear, causing 1 point of damage!

>attack mr h with rope
You attack Mr Hartman with rope, causing 2 points of damage!

>attack mr h with rope
You attack Mr Hartman with rope, causing 1 point of damage!

>mr h health
Mr Hartman has 7 health

>mr h health
Mr Hartman has 7 health

>attack mr h with rope
You attack Mr Hartman with rope, causing 1 point of damage!

>attack mr h with rope
You attack Mr Hartman with rope, causing 1 point of damage!

I beg your pardon?

>attack mr h with rope
You attack Mr Hartman with rope, causing 1 point of damage!

>attack mr h with rope
You attack Ghost Ghost Ghost Ghost Ghost Ghost Ghost Ghost Ghost Ghost Ghost Ghost Ghost Ghost Ghost Ghost Ghost Ghost Ghost Ghost 
*** Run-time problem P12: Too many activities are going on at once.

Glulxe fatal error: Stack overflow in function call.
Ghost Ghost Ghost Ghost Ghost Ghost Ghost Ghost Ghost Ghost Ghost Ghost Ghost Ghost Ghost Ghost Ghost Ghost Ghost Ghost Ghost Ghost Ghost Ghost Ghost Ghost Ghost Ghost Ghost Ghost Ghost Ghost Ghost Ghost Ghost Ghost Ghost Ghost Ghost Ghost Ghost Ghost Ghost Ghost Ghost Ghost Ghost Ghost Ghost Ghost Ghost Ghost Ghost Ghost Ghost Ghost Ghost Ghost Ghost Ghost Ghost Ghost Ghost Ghost Ghost Ghost Ghost Ghost Ghost Ghost Ghost Ghost Ghost Ghost Ghost Ghost Ghost Ghost Ghost Ghost Ghost Ghost Ghost Ghost Ghost Ghost Ghost Ghost Ghost Ghost Ghost Ghost Ghost Ghost Ghost Ghost Ghost Ghost Ghost Ghost Ghost Ghost Ghost Ghost Ghost Ghost Ghost Ghost Ghost Ghost Ghost Ghost Ghost Ghost Ghost Ghost

* * *

>w
West Upperclassmen Hall
Junior side of the hallway. Close to the Cafeteria.

1

>s
Room 214
Ms. Belvod's Classroom. Apparently she has a thing for Mr Redman. I certinly don't see the appeal...

You can see Ms Belvod here.

1

>n
West Upperclassmen Hall
Junior side of the hallway. Close to the Cafeteria.

1

>e
Upperclassmen Junction
Long coridors stretching left and right. An intimidating sight for underclassman.

You can see monkey wrench and axe here.

1

>e
East Upperclassmen Hall
Senior side of the hallway. Close to the Gym.

1

>s
1

>look
Room 213
Mr. Hartman's Classroom. I heard he once was caught eating out of the Cafeteria Garbage.

You can see Mr Hartman here.

1

>n
East Upperclassmen Hall
Senior side of the hallway. Close to the Gym.

1

>e
1

>w
East Upperclassmen Hall
Senior side of the hallway. Close to the Gym.

1

>e
1

>n
You can't go that way.

1

>w
East Upperclassmen Hall
Senior side of the hallway. Close to the Gym.

1

>w
Upperclassmen Junction
Long coridors stretching left and right. An intimidating sight for underclassman.

You can see monkey wrench and axe here.

1

>n
Underclassmen Hallway
Class just started, so the normally busy hallway seems eeriely quiet.

You can see My Locker (closed) and Diamonds Locker (closed) here.

1

>spin diamonds locker to 0315
Diamonds Locker opens, revealing Diamonds Pencil.

1Score! Her pencil is right where she said it would be.

You hear knuckles scraping the floor. A lightning rod shoots down your spine. Brad approaches.

>s
BRAD: You can't run from me!

 Your health is now 19

* * *

>s
Upperclassmen Junction
Long coridors stretching left and right. An intimidating sight for underclassman.

1

>look
Upperclassmen Junction
Long coridors stretching left and right. An intimidating sight for underclassman.

You can see katana here.

>take bat
You can't see any such thing.

>s
You can't go that way.

>w
West Upperclassmen Hall
Junior side of the hallway. Close to the Cafeteria.

You can see a scimitar here.

>take candlestick
You can't see any such thing.

>s
Room 214
Ms. Belvod's Classroom. Apparently she has a thing for Mr Redman. I certinly don't see the appeal...

You can see Ms Belvod here.

>take wrench
You can't see any such thing.

>attack ms b with wrench
You can't see any such thing.

>inventory
I got myself: 
halberd
a fish
a fist

>attack ms b with pike
You can't see any such thing.

>attack ms b with pike
You attack Ms Belvod with pike, causing 4 points of damage! Ms Belvod has 6 left. 
You are attacked with chainsaw, causing 7 points of damage! You have 4 left.

>attack ms b with bat
You attack Ms Belvod with baseball bat, causing 6 points of damage! Ms Belvod has 0 left.

>attack ms b with bat
stop beating a dead horse, Ms Belvod is already dead, dummy.

* * *

>s
Upperclassmen Junction
Long coridors stretching left and right. An intimidating sight for underclassman.

1

>e
East Upperclassmen Hall
Senior side of the hallway. Close to the Gym.

1

>s
Room 213
Mr. Hartman's Classroom. I heard he once was caught eating out of the Cafeteria Garbage.

You can see Mr Hartman and Diamond here.

1

>look
Room 213
Mr. Hartman's Classroom. I heard he once was caught eating out of the Cafeteria Garbage.

You can see Mr Hartman here.

>showme scene
There seems to be no such object anywhere in the model world.

* * *

>s
Room 213
Mr. Hartman's Classroom. I heard he once was caught eating out of the Cafeteria Garbage.

You can see Mr Hartman and Diamond here.

1

>ask diamond about school
DIAMOND: Oh thank goodness! We're supposed to start an exam in 5 minutes, and I left my pencil in my locker! Could you get it for me? The password is the birthday of my hero, RBG.

1

>ask diamond about school
I'm freaking out, guy. Can you hurry and get my pencil? Like I said, the password is the month and day that Ruth Bater Ginsberg was born.

1

>n
East Upperclassmen Hall
Senior side of the hallway. Close to the Gym.

1

>w
Upperclassmen Junction
Long coridors stretching left and right. An intimidating sight for underclassman.

1

>n
Underclassmen Hallway
Class just started, so the normally busy hallway seems eeriely quiet.

You can see My Locker (closed) and Diamonds Locker (closed) here.

1

>spin diamonds locker to -315
Click! nothing else happens.

1

>spin diamonds locker to 0315
Diamonds Locker opens, revealing Diamonds Pencil.

Score! Her pencil is right where she said it would be.

2
You hear knuckles scraping the floor. A lightning rod shoots down your spine. Brad approaches.

>take pencil
Taken.

2

>inventory
I got myself: 
Diamonds Pencil
pike
chainsaw
a fish
a fist

2

>attack brad with chainsaaw
You can't see any such thing.

>attack brad with chainsaw
You attack Brad with chainsaw, causing 8 points of damage! Brad has 12 health left. 
You are attacked with sledgehammer, causing 6 points of damage! You have 14 health left. 
2

>attack brad with chainsaw
You attack Brad with chainsaw, causing 7 points of damage! Brad has 5 health left. 
You are attacked with hockey stick, causing 5 points of damage! You have 9 health left. 
2

>attack brad with chainsaw
You attack Ghost Brad with chainsaw, causing 6 points of damage! Ghost Brad has -1 health left. 
You are attacked with Brad's Fist, causing 1 point of damage! You have 8 health left. 
2

* * *

>s
Upperclassmen Junction
Long coridors stretching left and right. An intimidating sight for underclassman.

1

>s
You can't go that way.

* * *

>look
Room 213
Mr. Hartman's Classroom. I heard he once was caught eating out of the Cafeteria Garbage.

You can see Mr Hartman here.

* * *

>e
Room 212
Mrs Ford's Classroom. She's a real stickler for the rules. Everything with its purpose, everything in its place.

You can see a scimitar and Mrs Ford here.

>look
Room 212
Mrs Ford's Classroom. She's a real stickler for the rules. Everything with its purpose, everything in its place.

You can see Mrs Ford here.

>inventory
I got myself: 
nunchucks
ice pick
a fish
a fist

>attack mrs f with sickle
You can't see any such thing.

>attack mrs f with sickle
You can't see any such thing.

>attack mrs f with sickle
You attack Mrs Ford with sickle, causing 1 point of damage! Mrs Ford has 11 left. 
You are attacked with spear, causing 1 point of damage! You have 4 left.

>attack mrs f with sickle
You attack Mrs Ford with sickle, causing 1 point of damage! Mrs Ford has 10 left. 
You are attacked with spear, causing 1 point of damage! You have 3 left.

>attack mrs f with sickle
You attack Mrs Ford with sickle, causing 1 point of damage! Mrs Ford has 9 left. 
You are attacked with Ford's Fist, causing 1 point of damage! You have 2 left.

>attack mrs f with sickle
You attack Mrs Ford with sickle, causing 1 point of damage! Mrs Ford has 8 left. 
You are attacked with Ford's Fist, causing 1 point of damage! You have 1 left.

>attack mrs f with sickle
You attack Mrs Ford with sickle, causing 1 point of damage! Mrs Ford has 7 left. 
You are attacked with Ford's Fist, causing 1 point of damage! You have 0 left.

>attack mrs f with sickle
You attack Mrs Ford with sickle, causing 1 point of damage! Mrs Ford has 6 left. 
You are attacked with spear, causing 1 point of damage! You have -1 left.

* * *

>e
Room 212
Mrs Ford's Classroom. She's a real stickler for the rules. Everything with its purpose, everything in its place.

You can see a scimitar and Mrs Ford here.

>w
Underclassmen Hallway
Class just started, so the normally busy hallway seems eeriely quiet.

You can see My Locker (closed) and Diamonds Locker (closed) here.

1

>w
Room 211
Mr Redman's Classroom. He's known for beating the living hell out of his kids. Not cool Mr Redman. Not cool.

You can see Mr Redman here.

1

>e
Underclassmen Hallway
Class just started, so the normally busy hallway seems eeriely quiet.

You can see My Locker (closed) and Diamonds Locker (closed) here.

1

>n
Steps
Hundreds of kids go up and down these steps everyday.

1

>n
Great Outdoors
Its pleasent and breezy. Much better than that that big block of concrete they call a school

You can see monkey wrench here.

1

>take wrench
Taken.

1

>s
Steps
Hundreds of kids go up and down these steps everyday.

1

>s
Underclassmen Hallway
Class just started, so the normally busy hallway seems eeriely quiet.

You can see My Locker (closed) and Diamonds Locker (closed) here.

1

>s
Upperclassmen Junction
Long coridors stretching left and right. An intimidating sight for underclassman.

1

>s
You can't go that way.

1

>e
East Upperclassmen Hall
Senior side of the hallway. Close to the Gym.

You can see rope and katana here.

1

>take katana
Taken.

1

>w
Upperclassmen Junction
Long coridors stretching left and right. An intimidating sight for underclassman.

1

* * *

>n
Underclassmen Hallway
Class just started, so the normally busy hallway seems eeriely quiet.

You can see My Locker (closed) and Diamonds Locker (closed) here.

1

>spin diamonds locker to 0315
Diamonds Locker opens, revealing Diamonds Pencil.

Score! Her pencil is right where she said it would be.

2
You hear knuckles scraping the floor. A lightning rod shoots down your spine. Brad approaches. 
 BRAD: Hey Ugly! What are you doing, sniffing panties? You're a loser, panty sniffer. Always will be. Now it's time for you to pay for being such a pathetic waste of space. 
 Brad always gets your blood boiling, but what's worse is you know he won't let you leave without trying to kill you. High school is rough like that. 
Check your inventory to see what you can defend yourself with

>attack brad with katana
You attack Brad with katana, causing 8 points of damage! Brad has 12 health left. 
You are attacked with sledgehammer, causing 6 points of damage! You have 14 health left. 
2

>attack brad with katana
You attack Brad with katana, causing 7 points of damage! Brad has 5 health left. 
You are attacked with hockey stick, causing 5 points of damage! You have 9 health left. 
2

>attack brad with katana
You attack Ghost Brad with katana, causing 6 points of damage! Ghost Brad has -1 health left. 
You are attacked with hockey stick, causing 4 points of damage! You have 5 health left. 
3
your hands are shaking, but you did it. You defeated your lifelong enemy. Some part of you is nervous, though. 
. 
 .. 
 ... 
.... 
 BRAD'S DISEMBODIED VOICE: What the actual hell!!! Why is my body on the ground??? What did you do to me, nerd!?!?!??! 
 You've stolen my life, so I'm going to steal what you live for!
 Your heart sinks. You know he could only be referring to one person- Diamond. You have to go find her.

All of a sudden there is a loud yell from down the hall. You think it might be coming from one of the classrooms.

>s
Upperclassmen Junction
Long coridors stretching left and right. An intimidating sight for underclassman.

3

>e
East Upperclassmen Hall
Senior side of the hallway. Close to the Gym.

You can see rope here.

3

>s
Room 213
Mr. Hartman's Classroom. I heard he once was caught eating out of the Cafeteria Garbage.

You can see Ghost Brad, baseball bat, Mr Hartman and Diamond here.

3

I beg your pardon?

>look
Room 213
Mr. Hartman's Classroom. I heard he once was caught eating out of the Cafeteria Garbage.

You can see Ghost Brad, baseball bat, Mr Hartman and Diamond here.

3

* * *

>e
Room 212
Mrs Ford's Classroom. She's a real stickler for the rules. Everything with its purpose, everything in its place.

You can see a scimitar and Mrs Ford here.

>take katana
Taken.

>w
Underclassmen Hallway
Class just started, so the normally busy hallway seems eeriely quiet.

You can see My Locker (closed) and Diamonds Locker (closed) here.

>spin diamonds locker to 0315
Diamonds Locker opens, revealing Diamonds Pencil.

Score! Her pencil is right where she said it would be.

You hear knuckles scraping the floor. A lightning rod shoots down your spine. Brad approaches. 
 BRAD: Hey Ugly! What are you doing, sniffing panties? You're a loser, panty sniffer. Always will be. Now it's time for you to pay for being such a pathetic waste of space. 
 Brad always gets your blood boiling, but what's worse is you know he won't let you leave without trying to kill you. High school is rough like that. 
Check your inventory to see what you can defend yourself with

>attack brad with katana
You attack Brad with katana, causing 8 points of damage! Brad has 12 health left. 
You are attacked with Brad's Fist, causing 1 point of damage! You have 19 health left.

>attack brad with katana
You attack Brad with katana, causing 7 points of damage! Brad has 5 health left. 
You are attacked with hockey stick, causing 5 points of damage! You have 14 health left.

>attack brad with katana
You attack Ghost Brad with katana, causing 6 points of damage! Ghost Brad has -1 health left. 
You are attacked with spear, causing 5 points of damage! You have 9 health left. 
your hands are shaking, but you did it. You defeated your lifelong enemy. Some part of you is nervous, though. 
. 
 .. 
 ... 
.... 
 BRAD'S DISEMBODIED VOICE: What the actual hell!!! Why is my body on the ground??? What did you do to me, nerd!?!?!??! 
 You've stolen my life, so I'm going to steal what you live for!
 Your heart sinks. You know he could only be referring to one person- Diamond. You have to go find her.

All of a sudden there is a loud yell from down the hall. You think it might be coming from one of the classrooms.

>s
Upperclassmen Junction
Long coridors stretching left and right. An intimidating sight for underclassman.

You can see candlestick here.

1

>take candlestick
Taken.

1

>e
East Upperclassmen Hall
Senior side of the hallway. Close to the Gym.

You can see monkey wrench here.

1

>take wrench
Taken.

1

>s
Room 213
Mr. Hartman's Classroom. I heard he once was caught eating out of the Cafeteria Garbage.

You can see Ghost Brad, baseball bat, a scimitar, Mr Hartman and Diamond here.

1

>take scimitar
Taken.

2

>look
Room 213
Mr. Hartman's Classroom. I heard he once was caught eating out of the Cafeteria Garbage.

You can see Ghost Brad, baseball bat, Mr Hartman and Diamond here.

3

* * *

>e
Room 212
Mrs Ford's Classroom. She's a real stickler for the rules. Everything with its purpose, everything in its place.

You can see a scimitar and Mrs Ford here.

>take scimitar
Taken.

>w
Underclassmen Hallway
Class just started, so the normally busy hallway seems eeriely quiet.

You can see baseball bat, My Locker (closed) and Diamonds Locker (closed) here.

>spin locker to 0315
Which do you mean, My Locker or Diamonds Locker?

>diamonds locker
Diamonds Locker opens, revealing Diamonds Pencil.

Score! Her pencil is right where she said it would be.

You hear knuckles scraping the floor. A lightning rod shoots down your spine. Brad approaches. 
 BRAD: Hey Ugly! What are you doing, sniffing panties? You're a loser, panty sniffer. Always will be. Now it's time for you to pay for being such a pathetic waste of space. 
 Brad always gets your blood boiling, but what's worse is you know he won't let you leave without trying to kill you. High school is rough like that. 
Check your inventory to see what you can defend yourself with

>attack brad with scimitar
You attack Brad with the scimitar, causing 8 points of damage! Brad has 12 health left. 
You are attacked with Brad's Fist, causing 1 point of damage! You have 19 health left.

>attack brad with scimitar
You attack Brad with the scimitar, causing 7 points of damage! Brad has 5 health left. 
You are attacked with Brad's Fist, causing 1 point of damage! You have 18 health left.

>attack brad with scimitar
You attack Ghost Brad with the scimitar, causing 6 points of damage! Ghost Brad has -1 health left. 
You are attacked with Brad's Fist, causing 1 point of damage! You have 17 health left. 
your hands are shaking, but you did it. You defeated your lifelong enemy. Some part of you is nervous, though. 
. 
 .. 
 ... 
.... 
 BRAD'S DISEMBODIED VOICE: What the actual hell!!! Why is my body on the ground??? What did you do to me, nerd!?!?!??! 
 You've stolen my life, so I'm going to steal what you live for!
 Your heart sinks. You know he could only be referring to one person- Diamond. You have to go find her.

All of a sudden there is a loud yell from down the hall. You think it might be coming from one of the classrooms.

>s
Upperclassmen Junction
Long coridors stretching left and right. An intimidating sight for underclassman.

1

* * *

>e
East Upperclassmen Hall
Senior side of the hallway. Close to the Gym.

1

>s
Room 213
Mr. Hartman's Classroom. I heard he once was caught eating out of the Cafeteria Garbage.

You can see Ghost Brad and Mr Hartman here.

1GHOST BRAD: Anyways, I'm sure you're looking for Diamond, and just to make your life more difficult, the shit-for-brains creators of this game brought me back to kidnap Diamond, and yatta yatta yatta, and something something, then you fight me again and win the game. Or I kill you. Doesn't really matter to me. Here's a clue for you. 
 Only in America is Pizza considered a vegetable. Go get your 3 servings a day

>look
Room 213
Mr. Hartman's Classroom. I heard he once was caught eating out of the Cafeteria Garbage.

You can see Mr Hartman here.

2

* * *

>examine locker
Which do you mean, My Locker or Diamonds Locker?

>my locker
Ah, my sweet old locker. Smells like teen spirit.

* * *

>w
Room 211
Mr Redman's Classroom. He's known for beating the living hell out of his kids. Not cool Mr Redman. Not cool.

You can see axe and Mr Redman here.

1

>look
Room 211
Mr Redman's Classroom. He's known for beating the living hell out of his kids. Not cool Mr Redman. Not cool.

You can see Mr Redman here.

>take katana
Taken.

>attack mr r with katana
You attack Mr Redman with katana, causing 8 points of damage!
Mr Redman is now your enemy.

(first taking Redman's Fist)
That seems to belong to Mr Redman.

* * *

>look
Room 211
Mr Redman's Classroom. He's known for beating the living hell out of his kids. Not cool Mr Redman. Not cool.

You can see Mr Redman here.

>take candlestick
Taken.

>attack mr r with candlestick
You attack Mr Redman with candlestick, causing 6 points of damage!

yourself attacks you with sickle, causing 3 points of damageyourself is now your enemy.

* * *

>look
Room 211
Mr Redman's Classroom. He's known for beating the living hell out of his kids. Not cool Mr Redman. Not cool.

You can see Mr Redman here.

>take rope
Taken.

>attack mr r with rope
You attack Mr Redman with rope, causing 3 points of damage! Mr Redman has 17 left. Mr Redman is now your enemy.

You are attacked with nunchucks, causing 6 points of damage! You have 14 left. yourself is now your enemy.

* * *

>look
Room 211
Mr Redman's Classroom. He's known for beating the living hell out of his kids. Not cool Mr Redman. Not cool.

You can see Mr Redman here.

>e
Underclassmen Hallway
Class just started, so the normally busy hallway seems eeriely quiet.

You can see My Locker (closed) and Diamonds Locker (closed) here.

* * *

>look
Room 212
Mrs Ford's Classroom. She's a real stickler for the rules. Everything with its purpose, everything in its place.

You can see Mrs Ford here.

>w
Underclassmen Hallway
Class just started, so the normally busy hallway seems eeriely quiet.

You can see My Locker (closed) and Diamonds Locker (closed) here.

* * *

>look
Upperclassmen Junction
Long coridors stretching left and right. An intimidating sight for underclassman.

>s
You can't go that way.

>w
West Upperclassmen Hall
Junior side of the hallway. Close to the Cafeteria.

You can see candlestick here.

>take candlestick
Taken.

* * *

>look
Cafeteria
Serving barely-edible food substance since 1989.

You can see baseball bat here.

>take bat
Taken.

>s
You can't go that way.

>w
You can't go that way.

* * *

>e
West Upperclassmen Hall
Junior side of the hallway. Close to the Cafeteria.

>s
Room 214
Ms. Belvod's Classroom. Apparently she has a thing for Mr Redman. I certinly don't see the appeal...

You can see katana and Ms Belvod here.

>take katana
Taken.

>attack ms b with katana
You attack Ms Belvod with katana, causing 8 points of damage! Ms Belvod has 12 left. Ms Belvod is now your enemy.

You are attacked with chainsaw, causing 8 points of damage! You have 12 left.

>attack ms b with katana
You attack Ms Belvod with katana, causing 7 points of damage! Ms Belvod has 5 left. 
You are attacked with chainsaw, causing 7 points of damage! You have 5 left.

>attack ms b with katana
You attack Ms Belvod with katana, causing 6 points of damage! Ms Belvod has -1 left. 
You are attacked with Belvod's Fist, causing 1 point of damage! You have 4 left.

>attack ms b with katana
You attack Ms Belvod with katana, causing 5 points of damage! Ms Belvod has -6 left. 
You are attacked with chainsaw, causing 6 points of damage! You have -2 left. 
You died in combat and failed Diamond. She gets Stockholm syndrome and falls in love with Brad, and they (live) happily ever after. You will haunt these halls for eternity, but because you died so pathetically, everyone forgets that you existed pretty quickly. Sucks to be you, loser.

    *** The End ***

Would you like to RESTART, RESTORE a saved game, QUIT or UNDO the last command?

* * *

>w
Room 211
Mr Redman's Classroom. He's known for beating the living hell out of his kids. Not cool Mr Redman. Not cool.

You can see axe and Mr Redman here.

1

>take axe
Taken.

1

>w
You can't go that way.

1

>s
You can't go that way.

1

>e
Underclassmen Hallway
Class just started, so the normally busy hallway seems eeriely quiet.

You can see My Locker (closed) and Diamonds Locker (closed) here.

1

>e
Room 212
Mrs Ford's Classroom. She's a real stickler for the rules. Everything with its purpose, everything in its place.

You can see katana and Mrs Ford here.

1

>take katana
Taken.

1

>e
You can't go that way.

1

>w
Underclassmen Hallway
Class just started, so the normally busy hallway seems eeriely quiet.

You can see My Locker (closed) and Diamonds Locker (closed) here.

1

>spin diamonds locker to 0315
Diamonds Locker opens, revealing Diamonds Pencil.

Score! Her pencil is right where she said it would be.

2
You hear knuckles scraping the floor. A lightning rod shoots down your spine. Brad approaches. 
 BRAD: Hey Ugly! What are you doing, sniffing panties? You're a loser, panty sniffer. Always will be. Now it's time for you to pay for being such a pathetic waste of space. 
 Brad always gets your blood boiling, but what's worse is you know he won't let you leave without trying to kill you. High school is rough like that. 
Check your inventory to see what you can defend yourself with

>attack brad with katana
You attack Brad with katana, causing 8 points of damage! Brad has 12 health left. 
You are attacked with Brad's Fist, causing 1 point of damage! You have 19 health left. 
2

>attack brad with katana
You attack Brad with katana, causing 7 points of damage! Brad has 5 health left. 
You are attacked with sledgehammer, causing 6 points of damage! You have 13 health left. 
2

>attack brad with katana
You attack Ghost Brad with katana, causing 6 points of damage! Ghost Brad has -1 health left. 
You are attacked with hockey stick, causing 5 points of damage! You have 8 health left. 
4

* * *

>take bat
Taken.

>take candlestick
Taken.

* * *

>look
Upperclassmen Junction
Long coridors stretching left and right. An intimidating sight for underclassman.

You can see katana here.

>take katana
Taken.

>s
You can't go that way.

>w
West Upperclassmen Hall
Junior side of the hallway. Close to the Cafeteria.

You can see rope here.

>take rope
Taken.

>s
Room 214
Ms. Belvod's Classroom. Apparently she has a thing for Mr Redman. I certinly don't see the appeal...

You can see Ms Belvod here.

>attack ms b with katana
You attack Ms Belvod with katana, causing 8 points of damage! Ms Belvod has 12 left. 
You are attacked with Belvod's Fist, causing 1 point of damage! You have 19 left.

>attack ms b with katana
You attack Ms Belvod with katana, causing 7 points of damage! Ms Belvod has 5 left. 
You are attacked with pike, causing 5 points of damage! You have 14 left.

>attack ms b with katana
You attack Ms Belvod with katana, causing 6 points of damage! Ms Belvod has -1 left. 
You are attacked with pike, causing 4 points of damage! You have 10 left.

* * *

>spin diamonds locker to 0315
Diamonds Locker opens, revealing Diamonds Pencil.

Score! Her pencil is right where she said it would be.

2
You hear knuckles scraping the floor. A lightning rod shoots down your spine. Brad approaches. 
 BRAD: Hey Ugly! What are you doing, sniffing panties? You're a loser, panty sniffer. Always will be. Now it's time for you to pay for being such a pathetic waste of space. 
 Brad always gets your blood boiling, but what's worse is you know he won't let you leave without trying to kill you. High school is rough like that. 
Check your inventory to see what you can defend yourself with

>take diamonds pencil
Taken.

>s
Upperclassmen Junction
Long coridors stretching left and right. An intimidating sight for underclassman.

You can see rope here.

* * *

>take pencil
Taken.

Score! Her pencil is right where she said it would be.

>s
Upperclassmen Junction
Long coridors stretching left and right. An intimidating sight for underclassman.

Score! Her pencil is right where she said it would be.

* * *

>inventory
I got myself: 
ice pick
a fish
a fist

2

>attack brad with spear
You attack Brad with spear, causing 5 points of damage! Brad has 15 health left. 
You are attacked with war hammer, causing 8 points of damage! You have 12 health left. 
2

>attack brad with spear
You attack Brad with spear, causing 4 points of damage! Brad has 11 health left. 
You are attacked with ice pick, causing 8 points of damage! You have 4 health left. 
2

>attack brad with spear
You attack Brad with spear, causing 3 points of damage! Brad has 8 health left. 
You are attacked with hockey stick, causing 5 points of damage! You have -1 health left. 
2
You died in combat and failed Diamond. She gets Stockholm syndrome and falls in love with Brad, and they (live) happily ever after. You will haunt these halls for eternity, but because you died so pathetically, everyone forgets that you existed pretty quickly. Sucks to be you, loser.

    *** The End ***

Would you like to RESTART, RESTORE a saved game, QUIT or UNDO the last command?

>attack brad with spear
You attack Brad with spear, causing 2 points of damage! Brad has 6 health left. 
You are attacked with pike, causing 5 points of damage! You have 3 health left. 
2

>attack brad with spear
You attack Brad with spear, causing 1 point of damage! Brad has 5 health left. 
You are attacked with chainsaw, causing 8 points of damage! You have -5 health left. 
2
You died in combat and failed Diamond. She gets Stockholm syndrome and falls in love with Brad, and they (live) happily ever after. You will haunt these halls for eternity, but because you died so pathetically, everyone forgets that you existed pretty quickly. Sucks to be you, loser.

    *** The End ***

Would you like to RESTART, RESTORE a saved game, QUIT or UNDO the last command?

* * *

>inventory
I got myself: 
ice pick
a fish
a fist

2

>attack brad with ice bick
I only understood you as far as wanting to attack Brad with ice pick.

>attack brad with ice pick
You attack Brad with ice pick, causing 8 points of damage! Brad has 12 health left. 
You are attacked with Brad's Fist, causing 1 point of damage! You have 19 health left. 
2

>attack brad with ice pick
You attack Brad with ice pick, causing 7 points of damage! Brad has 5 health left. 
You are attacked with sledgehammer, causing 6 points of damage! You have 13 health left. 
2

>attack brad with ice pick
You attack Ghost Brad with ice pick, causing 6 points of damage! Ghost Brad has -1 health left. 
You are attacked with hockey stick, causing 5 points of damage! You have 8 health left. 
4

* * *

>spin Diamonds locker to 0315
Diamonds Locker opens, revealing Diamonds Pencil.

* * *

>spin diaminds locker to 0315
You can't see any such thing.

>spin diamonds locker to 0315
Diamonds Locker opens, revealing Diamonds Pencil.

Score! Her pencil is right where she said it would be.

You hear knuckles scraping the floor. A lightning rod shoots down your spine. Brad approaches.

>s
BRAD: You can't run from me!

 Your health is now 19

>inventory
I got myself: 
halberd
a fish
a fist

>attack brad with halberd
You attack Brad with halberd, causing 5 points of damage! Brad has 25 health left. 
You are attacked with hockey stick, causing 5 points of damage! You have 14 health left.

* * *

>s
Upperclassmen Junction
Long coridors stretching left and right. An intimidating sight for underclassman.

You can see a scimitar here.

>e
East Upperclassmen Hall
Senior side of the hallway. Close to the Gym.

* * *

>look
Room 213
Mr. Hartman's Classroom. I heard he once was caught eating out of the Cafeteria Garbage.

You can see Mr Hartman here.

>n
East Upperclassmen Hall
Senior side of the hallway. Close to the Gym.

>w
Upperclassmen Junction
Long coridors stretching left and right. An intimidating sight for underclassman.

You can see a scimitar here.

>n
Underclassmen Hallway
Class just started, so the normally busy hallway seems eeriely quiet.

You can see candlestick, My Locker (closed) and Diamonds Locker (closed) here.

>e
Room 212
Mrs Ford's Classroom. She's a real stickler for the rules. Everything with its purpose, everything in its place.

You can see Mrs Ford here.

>w
Underclassmen Hallway
Class just started, so the normally busy hallway seems eeriely quiet.

You can see candlestick, My Locker (closed) and Diamonds Locker (closed) here.

>w
Room 211
Mr Redman's Classroom. He's known for beating the living hell out of his kids. Not cool Mr Redman. Not cool.

You can see Mr Redman here.

* * *

>incentory
I didn't understand that sentence.

>inventory
sickle - Damage Points: 3
  a fish
  a fist